11111111111111111111111111111
100000000000000C0000000000001
10100101001000001010000010101
10100100101010100010000010101
1P0000000C00C00000000000000C1
11111111111111111111111111111
