1111111111111111111111
1E000000000000000000000001
1100101001000000001011
101001001011000000010101
1P0000000C000000000000C1
1111111111111111111111
