1111111111111111111111111
1E1000000000001C10000C001
1010010100100001101001001
1010010010101010001001001
1P0000000C00C0000000000C1
1111111111111111111111111
