111111111
1000C0001
100010001
1C01110C1
100010001
1100C0011
100010001
100111001
1000100P1
1C00E00C1
111111111
